{
  "attributes": [
      1 ,1 ,1 ,17 ,17 ,17 ,17 ,17 ,17 ,17 ,17 ,17 ,17,
      1 ,1 ,1 ,1  ,1  ,1  ,1  ,1  ,1  ,17 ,17 ,17 ,17,
      0 ,0 ,0 ,17 ,17 ,17 ,17 ,17 ,17 ,1  ,1  ,0  ,0,
      0 ,0 ,0 ,0  ,0  ,0  ,0  ,0  ,0  ,0  ,0  ,0  ,0,
      0 ,0 ,0 ,0  ,0  ,0  ,0  ,0  ,0  ,0  ,0  ,0  ,0
  ],
  "datas": [
      0 ,0, 0 ,18 ,34 ,32 ,16 ,2  ,0 ,66 ,48 ,49 ,67,
      0 ,0, 0 ,0  ,0  ,0  ,0  ,0  ,0 ,50 ,64 ,65 ,51,
      0 ,0, 0 ,33 ,17 ,19 ,35 ,1  ,3 ,0  ,0  ,0  ,0,
      0 ,0, 0 ,0  ,0  ,0  ,0  ,0  ,0 ,0  ,0  ,0  ,0,
      0 ,0 ,0 ,0  ,0  ,0  ,0  ,0  ,0 ,0  ,0  ,0  ,0
  ]
}
